luopua	neg	abandon
hylätty	neg	abandoned
hylkääminen	neg	abandonment
abba	pos	abba
sieppaus	neg	abduction
poikkeuksellinen	neg	aberrant
poikkeama	neg	aberration
inhota	neg	abhor
vastenmielinen	neg	abhorrent
kyky	pos	ability
viheliäinen	neg	abject
poikkeava	neg	abnormal
lakkauttaa	neg	abolish
poistaminen	neg	abolition
iljettävä	neg	abominable
inhottavuus	neg	abomination
keskeyttää	neg	abort
abortti	neg	abortion
epäonnistunut	neg	abortive
Edellä mainittujen	pos	abovementioned
hiertymä	neg	abrasion
kumota	neg	abrogate
paise	neg	abscess
poissaolo	neg	absence
poissa	neg	absent
poissaolija	neg	absentee
poissaolot	neg	absenteeism
absoluuttinen	pos	absolute
synninpäästö	pos	absolution
imeytyy	pos	absorbed
järjetön	neg	absurd
järjettömyys	neg	absurdity
runsaus	pos	abundance
runsas	pos	abundant
hyväksikäyttö	neg	abuse
pohjaton	neg	abysmal
syvyys	neg	abyss
akateeminen	pos	academic
akatemia	pos	academy
hyväksyttävä	pos	acceptable
hyväksyminen	pos	acceptance
saatavilla	pos	accessible
onnettomuus	neg	accident
satunnainen	neg	accidental
kunnianosoitus	pos	accolade
majoitus	pos	accommodation
säestys	pos	accompaniment
suorittaa	pos	accomplish
suoritettu	pos	accomplished
suoritus	pos	accomplishment
sopimus	pos	accord
vastuullisuus	pos	accountability
tilivelvollinen	pos	accountable
valtuutettu	pos	accredited
Accueil	pos	accueil
tarkka	pos	accurate
kirottu	neg	accursed
syytös	neg	accusation
akkusatiivi	neg	accusative
syytetty	neg	accused
syyttäjä	neg	accuser
syyttäen	neg	accusing
ässä	pos	ace
särky	neg	ache
saavuttaa	pos	achieve
saavutus	pos	achievement
kipeä	neg	aching
happo	neg	acid
kuittaus	pos	acknowledgment
hankkia	pos	acquire
hankkiminen	pos	acquiring
akrobaatti	pos	acrobat
toiminta	pos	action
kannekelpoinen	neg	actionable
todellinen	pos	actual
terävyys	pos	acuity
terävyys	pos	acumen
sopeuttaa	pos	adapt
mukautuva	pos	adaptable
kyykäärme	neg	adder
riippuvuus	neg	addiction
osoitteet	pos	addresses
mestari	pos	adept
riittävyys	pos	adequacy
rasva-	neg	adipose
ratkaista	neg	adjudicate
lisä	pos	adjunct
ihailtava	pos	admirable
amiraali	pos	admiral
ihailu	pos	admiration
ihailla	pos	admire
ihailija	pos	admirer
hyväksyttävä	pos	admissible
kehotus	neg	admonition
ihana	pos	adorable
palvonta	pos	adoration
jumaloida	pos	adore
tuuliajolla	neg	adrift
väärennetyllä	neg	adulterated
aviorikos	neg	adultery
edistää	pos	advance
kehittynyt	pos	advanced
edistäminen	pos	advancement
etu	pos	advantage
edullinen	pos	advantageous
tulo	pos	advent
seikkailu	pos	adventure
seikkailunhaluinen	pos	adventurous
vastustaja	neg	adversary
haitallinen	neg	adverse
vastoinkäyminen	neg	adversity
suositeltava	pos	advisable
neuvoa	pos	advise
neuvonantaja	pos	adviser
asianajo	pos	advocacy
esteettinen	pos	aesthetic
estetiikka	pos	aesthetics
rakastettava	pos	affable
tunteet	pos	affection
sidoksissa	pos	affiliated
vakuuttaa	pos	affirm
vakuutus	pos	affirmation
myöntävä	pos	affirmative
myöntävän	pos	affirmatively
vaivata	neg	afflict
koetelleet	neg	afflicted
koettelemus	neg	affliction
yltäkylläisyys	pos	affluence
hyvinvoiva	pos	affluent
antaa	pos	afford
loukkaus	neg	affront
peloissaan	neg	afraid
jälkimainingit	neg	aftermath
jälkimaku	neg	aftertaste
aga	pos	aga
törkeä	neg	aggravated
raskauttava	neg	aggravating
paheneminen	neg	aggravation
aggressio	neg	aggression
aggressiivinen	neg	aggressive
Hyökkääjän	neg	aggressor
kauhistunut jstk	neg	aghast
ketterä	pos	agile
ketteryys	pos	agility
kiihtynyt	neg	agitated
levottomuus	neg	agitation
tuskallinen	neg	agonizing
tuska	neg	agony
suostua	pos	agree
miellyttävä	pos	agreeable
sovittu	pos	agreed
sopiminen	pos	agreeing
sopimus	pos	agreement
maatalous	pos	agriculture
karille	neg	aground
eteenpäin	pos	ahead
tuki	pos	aid
avunanto	pos	aiding
vaivata	neg	ail
sairaalloinen	neg	ailing
päämäärätön	neg	aimless
tärkeily	neg	airs
alabasteri	pos	alabaster
hälytys	neg	alarm
hälyttävä	neg	alarming
alkoholismi	neg	alcoholism
valppaus	pos	alertness
ulkomaalainen	neg	alien
luovuttaa	neg	alienate
vieraantuneet	neg	alienated
vieraantuminen	neg	alienation
ravinto	pos	alimentation
elatusapu	neg	alimony
elossa	pos	alive
lievittää	pos	allay
väite	neg	allegation
väittää	neg	allege
uskollisuus	pos	allegiance
allegro	pos	allegro
lievittää	pos	alleviate
lievitys	pos	alleviation
liittoutunut	pos	allied
sallittu	pos	allowable
viehättää	pos	allure
viettelevä	pos	alluring
liittolainen	pos	ally
kaikkivaltias	pos	almighty
näkemiin	pos	aloha
syrjässä	neg	aloof
kiista	neg	altercation
hämmästyttävän	pos	amazingly
suurlähettiläs	pos	ambassador
epäselvä	neg	ambiguous
kunnianhimo	pos	ambition
väijytys	neg	ambush
parantaa	pos	ameliorate
aamen	pos	amen
myöntyväinen	pos	amenable
muuttaa	pos	amend
muutetaan	pos	amends
mukavuudet	pos	amenity
rakastettava	pos	amiable
sovinnollinen	pos	amicable
muistinmenetys	neg	amnesia
yleinen armahdus	pos	amnesty
rakkausjuttu	pos	amour
amfetamiinit	neg	amphetamines
huvittaa	pos	amuse
huvittunut	pos	amused
huvi	pos	amusement
huvittava	pos	amusing
Anaconda	neg	anaconda
anaali-	neg	anal
analyytikko	pos	analyst
anarkismi	neg	anarchism
anarkisti	neg	anarchist
anarkia	neg	anarchy
pannajulistus	neg	anathema
ankkuri	pos	anchor
ankkurointi	pos	anchorage
muinainen	neg	ancient
enkeli	pos	angel
enkelimäinen	pos	angelic
viha	neg	anger
angina	neg	angina
onkiminen	neg	angling
suuttunut	neg	angry
ahdistus	neg	anguish
elävöittää	pos	animate
eloisa	pos	animated
vihamielisyys jtk kohtaan	neg	animosity
animus	neg	animus
tuhota	neg	annihilate
tuhotuksi	neg	annihilated
tuhoaminen	neg	annihilation
ärsyttää	neg	annoy
harmi	neg	annoyance
kiusallinen	neg	annoying
kumota	neg	annul
kumoaminen	neg	annulment
poikkeus	neg	anomaly
anonyymi	neg	anonymous
vihamielisyys	neg	antagonism
antagonisti	neg	antagonist
vihamielinen	neg	antagonistic
pernarutto	neg	anthrax
antibiootit	pos	antibiotics
antikristus	neg	antichrist
vastamyrkky	pos	antidote
antifungal	pos	antifungal
vastenmielisyys	neg	antipathy
vanhentunut	neg	antiquated
antiikki	pos	antique
antiseptinen	pos	antiseptic
ihmisiä vihaava	neg	antisocial
antiteesi	neg	antithesis
levottomuus	neg	anxiety
innokas	neg	anxious
apache	neg	apache
apaattinen	neg	apathetic
apatia	neg	apathy
kirva	neg	aphid
itsevarmuus	pos	aplomb
anteeksipyytävä	pos	apologetic
anteeksi	pos	apologize
anteeksipyyntö	pos	apology
apostoli	pos	apostle
kauhistuttava	neg	appalling
umpilisäkkeen tulehdus	neg	appendicitis
suosionosoitukset	pos	applause
arvostus	pos	appreciation
pelko	neg	apprehension
levoton	neg	apprehensive
suostumus	pos	approbation
määräraha	neg	appropriation
hyväksyminen	pos	approval
hyväksyä	pos	approve
hyväksyvä	pos	approving
osuva	pos	apt
soveltuvuus	pos	aptitude
arkeologia	pos	archaeology
arkaainen	neg	archaic
kiihkeä	pos	ardent
kiihko	pos	ardor
vaivalloinen	neg	arduous
väitellä	neg	argue
perustelu	neg	argument
väittelynhaluinen	neg	argumentative
hedelmätön	neg	arid
ylhäisö	pos	aristocracy
aristokraattinen	pos	aristocratic
aseistuksen	neg	armaments
aseellinen	pos	armed
panssari	pos	armor
tuoksu	pos	aroma
herättää	pos	arouse
arraignment	neg	arraignment
ryhmä	pos	array
jälkikäteen	neg	arrears
pidätys	neg	arrest
ylimielisyys	neg	arrogance
ylimielinen	neg	arrogant
arsenikki	neg	arsenic
tuhopoltto	neg	arson
taide	pos	art
niveltää	pos	articulate
artikulaatio	pos	articulation
tykistö	neg	artillery
käsityöläinen	pos	artisan
viihdetaiteilija	pos	artiste
taiteellinen	pos	artistic
ylemmyys	pos	ascendancy
nousu	pos	ascent
tuhka	neg	ash
häpeissään	neg	ashamed
tuhkat	neg	ashes
toive	pos	aspiration
aspire	pos	aspire
kunnianhimoinen	pos	aspiring
perse	neg	ass
ahdistaa	neg	assail
hyökkääjä	neg	assailant
salamurhaaja	neg	assassin
murhata	neg	assassinate
salamurha	neg	assassination
pahoinpitely	neg	assault
kokoonpano	pos	assembly
suostumus	pos	assent
väittäen	pos	asserting
omaisuus	pos	assets
kusipää	neg	asshole
auttaa	pos	assist
apu	pos	assistance
työtoveri	pos	associate
tyynnyttää	pos	assuage
varmuus	pos	assurance
varma	pos	assured
hämmästyttävän	pos	astonishingly
hämmästys	pos	astonishment
harhaan	neg	astray
supistava	neg	astringent
astrologi	pos	astrologer
astronautti	pos	astronaut
tähtitieteilijä	pos	astronomer
neuvokas	pos	astute
turvapaikka	neg	asylum
ateismi	neg	atheism
ateroskleroosi	neg	atherosclerosis
urheilija	pos	athlete
urheilu-	pos	athletic
atomi	pos	atom
sovittaa	pos	atone
sovitus	pos	atonement
julma	neg	atrocious
julmuus	neg	atrocity
surkastuminen	neg	atrophy
liite	pos	attachment
hyökkäys	neg	attack
hyökkää	neg	attacking
saavutettavissa	pos	attainable
saavuttaminen	pos	attainment
liittyvä	pos	attendant
huomio	pos	attention
tarkkaavainen	pos	attentive
heikennettyjä	neg	attenuated
vaimennus	neg	attenuation
osoittaa	pos	attest
asianajaja	pos	attorney
nähtävyys	pos	attraction
houkuttelevuutta	pos	attractiveness
rohkeus	neg	audacity
lisätä	pos	augment
elokuu	pos	august
täti	pos	aunt
aura	pos	aura
lupaava	pos	auspicious
karu	neg	austere
ankaruus	neg	austerity
aito	pos	authentic
aitous	pos	authenticity
kirjailija	pos	author
arvovaltainen	pos	authoritative
auktoriteetti	pos	authority
valtuutus	pos	authorization
sallittua	pos	authorized
itsevaltainen	neg	autocratic
ruumiinavaus	neg	autopsy
lumivyöry	neg	avalanche
ahneus	neg	avarice
avatar	pos	avatar
kostaja	neg	avenger
vastahakoinen	neg	averse
vastenmielisyys	neg	aversion
välttää	neg	avoid
välttäminen	neg	avoidance
palkinto	pos	award
hirveä	neg	awful
awkwardness	neg	awkwardness
vinossa	neg	awry
ay	pos	ay
kyllä	pos	aye
leperrellä	neg	babble
höpinää	neg	babbling
paviaani	neg	baboon
vauva	pos	baby
kandidaatin arvo	pos	baccalaureate
selkäranka	pos	backbone
taaksepäin	neg	backward
taaksepäin	neg	backwards
suvanto	neg	backwater
bakteerit	neg	bacteria
bakteeria	neg	bacterium
huono	neg	bad
mäyrä	neg	badger
huonosti	neg	badly
badness	neg	badness
haastemies	neg	bailiff
syötti	neg	bait
tasapaino	pos	balance
tasapainoinen	pos	balanced
paali	neg	bale
parru	neg	balk
balladi	pos	ballad
baletti	pos	ballet
äänestys	pos	ballot
lohtu	pos	balm
palsami	pos	balsam
kielto	neg	ban
bandiitti	neg	bandit
kirous	neg	bane
pamaus	neg	bang
makkara	neg	banger
karkottaa maasta	neg	banish
karkotti	neg	banished
karkotus	neg	banishment
konkurssiin	neg	bankrupt
konkurssi	neg	bankruptcy
juhla-ateria	pos	banquet
banshee	neg	banshee
kaste	pos	baptism
kaste-	pos	baptismal
väkänen	neg	barb
barbaari	neg	barbarian
sivistymätön	neg	barbaric
barbaria	neg	barbarism
bardi	pos	bard
tinkiä	pos	bargain
kaarna	neg	bark
vanhentunut	neg	barred
karu	neg	barren
barrikadi	neg	barricade
este	neg	barrier
perätön	neg	baseless
koripallo	pos	basketball
kusipää	neg	bastard
linnake	pos	bastion
kylpy	pos	bath
taikina	neg	batter
kolhiintunut	neg	battered
paristo	neg	battery
taistelu	neg	battle
taisteli	neg	battled
taistelukenttä	neg	battlefield
kaksimielinen	neg	bawdy
pistin	neg	bayonet
palkki	pos	beam
säteilevä	pos	beaming
haltija	neg	bearer
peto	neg	beast
sikamainen	neg	beastly
selkäsauna	neg	beating
kaunistamiseen	pos	beautification
kaunis	pos	beautiful
kaunistaa	pos	beautify
kauneus	pos	beauty
kallioperä	pos	bedrock
olut	pos	beer
sattua	neg	befall
sovelias	pos	befitting
osoittaa jklle ystävällisyyttä	pos	befriend
kerjätä	neg	beg
kerjäläinen	neg	beggar
kerjäämässä	neg	begging
behemoth	neg	behemoth
kiitollisuudenvelassa	neg	beholden
myöhästynyt	neg	belated
uskoen	pos	believing
vähätellä	neg	belittle
sotaisa	neg	belligerent
vyö	neg	belt
taivutin	neg	bender
hyväntekijä	pos	benefactor
suotuisa	pos	beneficial
hyöty	pos	benefit
hyväntahtoisuus	pos	benevolence
hyvänlaatuinen	pos	benign
sureva	neg	bereaved
kuolemantapaus	neg	bereavement
bereft	neg	bereft
sekaisin	neg	berserk
laituripaikka	pos	berth
eläimellinen	neg	bestial
pettää	neg	betray
petos	neg	betrayal
kihlattu	pos	betrothed
parannus	pos	betterment
juoma	pos	beverage
varokaa	neg	beware
ymmällään	neg	bewildered
puolueellisuus	neg	bias
puolueellinen	neg	biased
raamatullinen	pos	biblical
kinastelu	neg	bickering
ruumispaarit	neg	bier
kiihkoilija	neg	bigot
kiihkoileva	neg	bigoted
sappi	neg	bile
kaksikielinen	pos	bilingual
koepala	neg	biopsy
koivu	neg	birch
syntymä	pos	birth
syntymäpäivä	pos	birthday
syntymäpaikka	neg	birthplace
narttu	neg	bitch
purra	neg	bite
karvaasti	neg	bitterly
katkeruus	neg	bitterness
outo	neg	bizarre
musta	neg	black
blackjack	neg	blackjack
kiristys	neg	blackmail
blackness	neg	blackness
syyttää	neg	blame
nuhteeton	pos	blameless
mitäänsanomaton	neg	bland
herjaava	neg	blasphemous
jumalanpilkka	neg	blasphemy
räjähdys	neg	blast
räikeä	neg	blatant
jaarittelu	neg	blather
loimu	neg	blaze
synkkä	neg	bleak
verenvuoto	neg	bleeding
tahra	neg	blemish
siunata	pos	bless
siunattu	pos	blessed
siunaus	pos	blessing
siunaukset	pos	blessings
vitsaus	neg	blight
turmelleet	neg	blighted
sokea	neg	blind
sokaisi	neg	blinded
sokeasti	neg	blindly
sokeus	neg	blindness
autuus	pos	bliss
autuas	pos	blissful
rakkula	neg	blister
paisunut	neg	bloated
möykky	neg	blob
saarto	neg	blockade
veretön	pos	bloodless
verenvuodatus	neg	bloodshed
verenhimoinen	neg	bloodthirsty
verinen	neg	bloody
kukinta	pos	bloom
kukka	pos	blossom
häpeäpilkku	neg	blot
puhallin	neg	blower
mässäily	neg	blowout
blues	neg	blues
bluffi	neg	bluff
kömmähdys	neg	blunder
hämärtää	neg	blur
hämärtynyt	neg	blurred
punastua	neg	blush
ylpeillä	pos	boast
kehuskelevan	neg	boasting
henkivartija	pos	bodyguard
suo	neg	bog
väärä	neg	bogus
kiehua	neg	boil
boilerplate	neg	boilerplate
riehakas	pos	boisterous
rohkea	pos	bold
rohkeus	pos	boldness
vahvistaa	pos	bolster
pommi	neg	bomb
pommittaa	neg	bombard
pommitus	neg	bombardment
pommitti	neg	bombed
kultakaivos	pos	bonanza
orjuus	neg	bondage
joukkovelkakirjat	neg	bonds
bonne	pos	bonne
bonus	pos	bonus
pöö	neg	boo
hölmö	neg	booby
kirjaviisas	pos	bookish
kirjakauppa	pos	bookshop
lukutoukka	pos	bookworm
siunaus	pos	boon
viina	neg	booze
pitkästyttää	neg	bore
ikävystyminen	neg	boredom
tylsä	neg	boring
lainaaja	neg	borrower
vaivautua	neg	bother
huolehtimatta	neg	bothering
pohja	neg	bottom
sidottu	neg	bound
yltäkylläinen	pos	bountiful
palkkio	pos	bounty
kukkakimppu	pos	bouquet
ottelu	neg	bout
nauta	neg	bovine
poika	neg	boy
boikotti	neg	boycott
kerskailla	neg	brag
äly	pos	brains
brandy	neg	brandy
uhmakkuus	neg	bravado
urhoollisuus	pos	bravery
rähinä	neg	brawl
röyhkeä	neg	brazen
rikkominen	neg	breach
erittely	neg	breakdown
aamiainen	pos	breakfast
hengenvaarallinen	neg	breakneck
hajoaminen	neg	breakup
lahjoa	neg	bribe
lahjonta	neg	bribery
morsiamen	pos	bridal
morsian	pos	bride
sulhanen	pos	bridegroom
morsiusneito	pos	bridesmaid
prikaati	neg	brigade
kirkastaa	pos	brighten
kirkkaus	pos	brightness
loistava	pos	brilliant
tulikivi	neg	brimstone
harjas	neg	bristle
kyljittäin	neg	broadside
brokadi	pos	brocade
paahtaa	neg	broil
mursi	neg	broke
rikki	neg	broken
bordelli	neg	brothel
veli	pos	brother
veljeys	pos	brotherhood
veljellinen	pos	brotherly
mustelma	neg	bruise
brunt	neg	brunt
brutaali	neg	brutal
raakuus	neg	brutality
eläimellinen	neg	brute
pukki	pos	buck
kaveri	pos	buddy
bufetti	neg	buffet
vika	neg	bug
mörkö	neg	bugaboo
rakentaa	pos	build
rakennus	pos	building
sipulimainen	neg	bulbous
bulldoggi	pos	bulldog
luodinkestävä	pos	bulletproof
kiusata	neg	bully
pylly	neg	bum
bummer	neg	bummer
poiju	pos	buoy
rasittava	neg	burdensome
byrokratia	neg	bureaucracy
byrokraatti	neg	bureaucrat
murtovaras	neg	burglar
murtovarkaus	neg	burglary
hautaaminen	neg	burial
haudattu	neg	buried
Burke	neg	burke
palanut	neg	burnt
buss	pos	buss
murrettu	neg	busted
lihakauppias	neg	butcher
hovimestari	pos	butler
pusku	neg	butt
kanttiini	pos	buttery
uhkea	pos	buxom
sirinä	pos	buzz
buzzed	neg	buzzed
ohjaamo	pos	cab
salaliitto	neg	cabal
kaappi	pos	cabinet
kakofonia	neg	cacophony
moukka	neg	cad
ruumis	neg	cadaver
kahvila	pos	cafe
häkki	neg	cage
Laskettaessa	neg	calculating
laskin	pos	calculator
vasikka	pos	calf
tunteeton	neg	callous
puhelut	neg	calls
tyyni	pos	calm
kampanjointi	neg	campaigning
kanarialintu	pos	canary
peruuttaa	neg	cancel
syöpä	neg	cancer
vilpitön	pos	candid
ehdokas	pos	candidate
sokeroitu	pos	candied
syöpä	neg	canker
kannibaali	neg	cannibal
kannibalismi	neg	cannibalism
tykki	neg	cannon
kapitalisti	pos	capitalist
kapteeni	pos	captain
valloittaa	pos	captivate
valloittava	pos	captivating
vangittu	neg	captive
vankeus	neg	captivity
vangitsija	neg	captor
kaapata	neg	capture
ruho	neg	carcass
syöpä	neg	carcinoma
kardiomyopatia	neg	cardiomyopathy
ura	pos	career
huolellinen	pos	careful
huolellisesti	pos	carefully
varomattomuus	neg	carelessness
hyväillä	pos	caress
talonmies	pos	caretaker
karikatyyri	neg	caricature
karies	neg	caries
verilöyly	neg	carnage
lihallinen	neg	carnal
lihansyöjä-	neg	carnivorous
joululaulu	pos	carol
kartelli	neg	cartel
vesiputous	pos	cascade
tapaus	neg	case
käteinen	pos	cash
ruumisarkku	neg	casket
kasti	neg	caste
uhri	neg	casualty
kaihi	neg	cataract
katastrofi	neg	catastrophe
kategorinen	pos	categorical
tyydyttää	pos	cater
cathartic	pos	cathartic
tuomiokirkko	pos	cathedral
katetri	neg	catheter
varovaisuus	neg	caution
varovainen	pos	cautious
varovasti	pos	cautiously
luovuttaa	neg	cede
juhlittu	pos	celebrated
juhlii	pos	celebrating
juhla	pos	celebration
julkkis	pos	celebrity
taivaallinen	pos	celestial
hautausmaa	neg	cemetery
sensuroida	neg	censor
arvostella	neg	censure
keskus	pos	center
sadanpäämies	pos	centurion
aivojen	pos	cerebral
seremonia	pos	ceremony
varmuus	pos	certainty
Cess	neg	cess
lakkaaminen	neg	cessation
akanat	neg	chaff
hankauksen	neg	chafing
mielipaha	neg	chagrin
puheenjohtaja	pos	chairman
puheenjohtaja	pos	chairwoman
haaste	neg	challenge
mestari	pos	champion
laulu	pos	chant
kaaos	neg	chaos
kaoottinen	neg	chaotic
farssi	neg	charade
maksu	neg	chargeable
laturi	pos	charger
hyväntekeväisyys-	pos	charitable
hyväntekeväisyys	pos	charity
viehätys	pos	charm
onnekas	pos	charmed
viehättävä	pos	charming
jahdata	neg	chase
kuritus	neg	chastisement
siveys	pos	chastity
chattering	pos	chattering
puhelias	neg	chatty
halpa	neg	cheap
huijata	neg	cheat
tarkistuslista	pos	checklist
eläköön	pos	cheer
hyväntuulinen	pos	cheerful
iloisuus	pos	cheerfulness
hurraavat	pos	cheering
pirteä	pos	cheery
juustokakku	neg	cheesecake
kemisti	pos	chemist
vaalia	pos	cherish
kirsikka	pos	cherry
juoni	neg	chicane
päällikkö	pos	chieftain
lapsi	pos	child
lapsuus	pos	childhood
lapsellinen	neg	childish
kolea	neg	chilly
visertää	pos	chirp
taltta	pos	chisel
ritarilaitos	pos	chivalry
kloroformi	neg	chloroform
suklaa	pos	chocolate
valinta	pos	choice
kuoro	pos	choir
tukehtua	neg	choke
kolera	neg	cholera
pilkkoa	neg	chop
kuoro-	pos	choral
puuha	neg	chore
kertosäe	pos	chorus
valittu	pos	chosen
chowder	pos	chowder
krooninen	neg	chronic
kronikka	pos	chronicle
hihittää	pos	chuckle
kirkko	pos	church
siideri	pos	cider
savuke	neg	cigarette
ympärileikkaus	pos	circumcision
kiertäminen	pos	circumvention
kansalainen	pos	citizen
siviili-	pos	civil
kohteliaisuus	pos	civility
sivistys	pos	civilization
sivistynyt	pos	civilized
selvänäkijä	pos	clairvoyant
meteli	neg	clamor
taputtaa	pos	clap
selventää	pos	clarify
yhteentörmäys	neg	clash
clashing	neg	clashing
klassinen	pos	classic
klassinen	pos	classical
klassikoita	pos	classics
luokitella	pos	classify
kynsiä	neg	claw
puhdas	pos	clean
puhdistus	pos	cleaning
puhtaus	pos	cleanliness
siististi	pos	cleanly
puhdistaa	pos	cleanse
puhdistus	pos	cleansing
raivaaminen	pos	clearance
selvyys	pos	clearness
toimisto-	pos	clerical
taitava	pos	clever
nokkeluutta	pos	cleverness
kliimaksi	pos	climax
luostari	neg	cloister
läheisyys	pos	closeness
sulkeminen	pos	closure
vaatettaa	pos	clothe
sumea	neg	clouded
pilvisyys	neg	cloudiness
pelle	pos	clown
tallustella	neg	clump
kömpelö	neg	clumsy
koalitio	pos	coalition
rannikko	pos	coast
kokaiini	neg	cocaine
hallita pakolla	neg	coerce
pakko	neg	coercion
olla yhtä aikaa olemassa	pos	coexist
ruumisarkku	neg	coffin
vakuuttava	pos	cogent
kognitiivinen	pos	cognitive
yhtenäisyys	pos	coherence
johdonmukainen	pos	coherent
yhtenäinen	pos	cohesive
kylmä	neg	cold
kylmästi	neg	coldly
kylmyys	neg	coldness
koliikki	neg	colic
romahdus	neg	collapse
kollektiivisesti	pos	collectively
törmäys	neg	collision
salainen sopimus	neg	collusion
eversti	pos	colonel
jättiläismäinen	pos	colossal
kooma	neg	coma
tajuton	neg	comatose
taistelu	neg	combat
taistelija	neg	combatant
taistelunhaluinen	neg	combative
mukavuus	pos	comfort
komendantti	pos	commandant
komentava	pos	commanding
muistoksi	pos	commemorate
muistojuhla	pos	commemoration
muisto-	pos	commemorative
kiittää	pos	commend
kiitettävä	pos	commendable
kommentaattori	pos	commentator
passitus	neg	committal
sitoutunut	pos	committed
kommodori	pos	commodore
Commonwealth	pos	commonwealth
hälinä	neg	commotion
tiedottaa	pos	communicate
kommunikatiivinen	pos	communicative
yhteys	pos	communion
kommunismi	neg	communism
kommunistinen	neg	communist
yhteisö	pos	community
työmatkaliikenne	pos	commutation
matkustaa	pos	commute
seuralainen	pos	companion
myötätunto	pos	compassion
myötätuntoinen	pos	compassionate
yhteensopivuus	pos	compatibility
yhteensopiva	pos	compatible
mukaansatempaava	pos	compelling
hyvittää	pos	compensate
korvaavia	pos	compensatory
pätevyys	pos	competence
pätevyys	pos	competency
pätevä	pos	competent
kilpailu	neg	competition
omahyväisyys	pos	complacency
kannella	neg	complain
valitus	neg	complaint
täydennys	pos	complement
täydentävä	pos	complementary
täysin	pos	completely
täydellisyys	pos	completeness
Suoritettuaan	pos	completing
valmistuminen	pos	completion
kompleksoituna	neg	complexed
monimutkaisuus	neg	complexity
noudattaminen	pos	compliance
yhteensopiva	pos	compliant
mutkistaa	neg	complicate
monimutkainen	neg	complicated
komplikaatio	neg	complication
rikoskumppanuus	pos	complicity
kohteliaisuus	pos	compliment
kokoonpanossa	pos	composed
säveltäjä	pos	composer
komposti	neg	compost
maltti	pos	composure
ymmärtää	pos	comprehend
kattava	pos	comprehensive
pakko	neg	compulsion
pakollinen	neg	compulsory
toveri	pos	comrade
salata	neg	conceal
piilotettu	neg	concealed
salaaminen	neg	concealment
itserakkaus	neg	conceit
omahyväinen	neg	conceited
samankeskinen	pos	concentric
sovittelu	pos	conciliation
päätös-	pos	concluding
sopu	pos	concord
konkordanssi	pos	concordance
aivotärähdys	neg	concussion
tuomita	neg	condemn
tuomitseminen	neg	condemnation
alentuva	neg	condescending
alentuvaisuus	neg	condescension
surunvalittelut	pos	condolence
suvaita	pos	condone
edistävä	pos	conducive
johtokyky	pos	conductivity
liittoutunut	pos	confederate
tunnustaa	pos	confess
tunnustus	neg	confession
itseluottamus	pos	confidence
luottavainen	pos	confident
rajoittaa	neg	confine
rajoitettu	neg	confined
synnytys	neg	confinement
vahvistettu	pos	confirmed
takavarikoida	neg	confiscate
takavarikointi	neg	confiscation
suurpalo	neg	conflagration
konflikti	neg	conflict
ristiriitainen	neg	conflicting
mukaisuudesta	pos	conformance
sekoittaa	neg	confound
kirottu	neg	confounded
sekoittaa	neg	confuse
sekaannus	neg	confusion
samanhenkinen	pos	congenial
ruuhka	neg	congestion
onnittelu	pos	congratulatory
seurakunta	pos	congregation
kongruenssi	pos	congruence
loihtivat	neg	conjuring
tuntija	pos	connoisseur
valloitus	neg	conquest
omatunto	pos	conscience
tunnollinen	pos	conscientious
tajunta	pos	consciousness
vihkiminen	pos	consecration
säilyttäminen	pos	conservation
säästää	pos	conserve
huomattava	pos	considerable
huomaavainen	pos	considerate
johdonmukaisuus	pos	consistency
konsoli	pos	console
konsonantti	pos	consonant
salaliittolainen	neg	conspirator
vehkeillä	neg	conspire
muuttumattomuus	pos	constancy
jatkuva	pos	constant
tyrmistys	neg	consternation
ummetus	neg	constipation
perustuslaillinen	pos	constitutional
rajoittaa	neg	constrain
rajoittaa	neg	constrained
rajoitus	neg	constraint
rakentaa	pos	construct
täydellistää	pos	consummate
yhteydenotto	pos	contact
tartunta	neg	contagion
tarttuva	neg	contagious
saastuttaa	neg	contaminate
saastunut	neg	contaminated
saastuminen	neg	contamination
miettiminen	pos	contemplation
ylenkatse	neg	contempt
halveksittava	neg	contemptible
halveksiva	neg	contemptuous
pitoisuus	pos	content
riidanalainen	neg	contentious
jatkaa	pos	continue
muoto	pos	contour
salakuljetustavara	neg	contraband
supistui	neg	contracted
ristiriidassa	neg	contradict
ristiriitaisuus	neg	contradiction
ristiriitainen	neg	contradictory
päinvastainen	neg	contrary
ristiriitaisia	neg	contrasted
rikkoa	neg	contravene
rikkomus	neg	contravention
edistää	pos	contribute
avustaja	pos	contributor
kiistanalainen	neg	controversial
kiista	neg	controversy
mukavuus	pos	convenience
mukava	pos	convenient
luostari	pos	convent
sopimus	pos	convention
perehtynyt	pos	conversant
puhekielen	pos	conversational
muuntaa	pos	convert
tuomittu	neg	convict
vakaumus	neg	conviction
vakuuttaa	pos	convince
viileä	pos	cool
viileys	pos	coolness
coop	neg	coop
yhteistyössä	pos	cooperate
Yhteistyössä	pos	cooperating
yhteistyö	pos	cooperation
osuuskunta	pos	cooperative
kopio	neg	copy
apina	neg	copycat
ydin	pos	core
kruunajaiset	pos	coronation
kuolemansyyntutkija	neg	coroner
alikersantti	neg	corporal
yhtiö	pos	corporation
ruumiillinen	pos	corporeal
ruumis	neg	corpse
korjaus	neg	correction
korjaavat	pos	corrective
kirjeenvaihto	pos	correspondence
vahvistaa	pos	corroborate
korroosio	neg	corrosion
syövyttävä	neg	corrosive
turmeltunut	neg	corrupt
turmelee	neg	corrupting
korruptio	neg	corruption
kosmopoliittinen	pos	cosmopolitan
kodikas	pos	cosy
yskä	neg	cough
neuvosto	pos	council
neuvo	pos	counsel
neuvonantaja	neg	counsellor
neuvonantaja	pos	counselor
laskea	pos	count
kreivitär	pos	countess
rohkeus	pos	courage
rohkea	pos	courageous
jäniksenajo	neg	coursing
kohtelias	pos	courteous
kohteliaisuus	pos	courtesy
kosiskelu	pos	courtship
lahti	pos	cove
liitto	pos	covenant
himoita	neg	covet
pelkuri	neg	coward
pelkuruus	neg	cowardice
pelkurimainen	neg	cowardly
äkäinen	neg	crabby
crack	neg	crack
säröillä	neg	cracked
halkeilua	neg	cracking
kehto	pos	cradle
käsityö	pos	craft
käsityöläinen	pos	craftsman
kramppi	neg	cramp
ahdas	neg	cramped
kampi	neg	crank
äkäinen	neg	cranky
paska	neg	crap
romahdus	neg	crash
ryömiä	neg	crawl
mieletön	neg	crazed
hullu	neg	crazy
narisevia	neg	creaking
kerma	pos	cream
luoda	pos	create
luova	pos	creative
olento	neg	creature
usko	pos	credence
credential	pos	credential
uskottavuus	pos	credibility
uskottava	pos	credible
luotto	pos	credit
kiitettävä	pos	creditable
hyvitetään	pos	credited
viruminen	neg	creep
crescendo	pos	crescendo
rikollisuus	neg	crime
rikollinen	neg	criminal
rikollisuus	neg	criminality
kyyristyä	neg	cringe
raajarikko	neg	cripple
rujo	neg	crippled
kriisi	neg	crisis
terävä	neg	crisp
kriitikko	neg	critic
kritiikki	neg	criticism
arvostella	neg	criticize
kritiikki	pos	critique
roisto	neg	crook
risti	neg	cross
hiipivä	neg	crouching
kruunaus	pos	crowning
ratkaiseva	pos	crucial
cruciate	neg	cruciate
ristiinnaulitseminen	neg	crucifixion
raakaöljy	neg	crude
julma	neg	cruel
julmasti	neg	cruelly
julmuus	neg	cruelty
murenemassa	neg	crumbling
räsähdys	neg	crunch
ristiretki	neg	crusade
murskattu	neg	crushed
murskaava	neg	crushing
kärttyisä	neg	crusty
itkeä	neg	cry
huutava	neg	crying
krypta	neg	crypt
kristalli	pos	crystal
aisankannattaja	neg	cuckold
käki	neg	cuckoo
halata	pos	cuddle
kulinaarinen	pos	culinary
teurastaa	neg	cull
huippukohta	pos	culmination
syyllisyydestä	neg	culpability
moitittava	neg	culpable
syyllinen	neg	culprit
kultti	neg	cult
viljellä	pos	cultivate
viljelty	pos	cultivated
viljely	pos	cultivation
kulttuuri	pos	culture
hankala	neg	cumbersome
ovela	pos	cunning
kuppaus	neg	cupping
rakki	neg	cur
parannettavissa oleva	pos	curable
uteliaisuus	pos	curiosity
curl	pos	curl
kirous	neg	curse
kirottu	neg	cursed
kirous	neg	cursing
pintapuolinen	neg	cursory
tyyny	pos	cushion
asiakas	pos	customer
söpö	pos	cute
leikkuri	neg	cutter
leikkurit	pos	cutters
murhamies	neg	cutthroat
leikkaus	neg	cutting
syanidi	neg	cyanide
sykloni	neg	cyclone
kysta	neg	cyst
sytomegalovirus	neg	cytomegalovirus
dabbling	neg	dabbling
demoni	neg	daemon
mieletön	neg	daft
tikari	neg	dagger
vahinko	neg	damage
vahingonkorvaus	neg	damages
rouva	pos	dame
pahuksen	neg	damn
kadotus	neg	damnation
kirottu	neg	damned
vaimennin	neg	damper
tanssi	pos	dance
hilse	neg	dandruff
keikari	neg	dandy
vaara	neg	danger
vaarallinen	neg	dangerous
uskalias	pos	daring
tummentaa	neg	darken
tummennettu	neg	darkened
pimeys	neg	darkness
rakas	pos	darling
romutti	neg	dashed
hurtti	pos	dashing
viheliäinen	neg	dastardly
tytär	pos	daughter
valjeta	pos	dawn
päästään pyörällä	neg	dazed
poistaa	neg	deactivate
umpikuja	neg	deadlock
tappava	neg	deadly
kuuro	neg	deaf
sopimus	pos	deal
rakas	pos	dear
kuolema	neg	death
romahdus	neg	debacle
keskustelu	pos	debate
irstailu	neg	debauchery
jätteet	neg	debris
velka	neg	debt
velallinen	neg	debtor
rappeutuminen	neg	decay
rappeutunut	neg	decayed
kuollut	neg	deceased
vilppi	neg	deceit
petollinen	neg	deceitful
pettää	neg	deceive
petti	neg	deceived
pettää	neg	deceiving
säädyllisyys	pos	decency
kunnollinen	pos	decent
petos	neg	deception
petollinen	neg	deceptive
toteava	pos	declaratory
eranto	neg	declination
aleneminen	neg	decline
laskussa	neg	declining
hajoaminen	neg	decomposition
vähentää	neg	decrease
vähennys	neg	decrement
ränsistynyt	neg	decrepit
halventaa	neg	decry
omistautuminen	pos	dedication
vähentää	neg	deduct
kunnianloukkaus	neg	defamation
loukkaava	neg	defamatory
oletusarvo	neg	default
tappio	neg	defeat
kukisti	neg	defeated
vika	neg	defect
loikkaus	neg	defection
viallinen	neg	defective
puolustaa	pos	defend
puolusti	pos	defended
puolustaja	pos	defender
puolustava	pos	defending
puolustus	pos	defense
puolustuskyvytön	neg	defenseless
kunnioitus	pos	deference
lykkäys	neg	deferral
uhma	neg	defiance
uhmakas	neg	defiant
puute	neg	deficiency
alijäämä	neg	deficit
lopullinen	pos	definitive
tyhjetä	neg	deflate
deflaatio	neg	deflation
rumentaa	neg	deform
epämuodostunut	neg	deformed
epämuodostuma	neg	deformity
petkuttaa	neg	defraud
kuollut	neg	defunct
uhmata	neg	defy
degeneraatio	neg	degeneracy
rappeutua	neg	degenerate
hajoaminen	neg	degradation
hajota	neg	degrade
halventava	neg	degrading
aste	pos	degree
viive	neg	delay
myöhässä	neg	delayed
herkullinen	pos	delectable
valtuutettu	pos	delegate
vahingollinen	neg	deleterious
poisto	neg	deletion
tarkoituksellinen	pos	deliberate
herkullinen	pos	delicious
ilo	pos	delight
iloinen	pos	delighted
ihastuttava	pos	delightful
rikollisuus	neg	delinquency
rikollinen	neg	delinquent
haltioitunut	neg	delirious
houretila	neg	delirium
pelastus	pos	deliverance
toimitus	pos	delivery
vedenpaisumus	neg	deluge
harhakuvitelma	neg	delusion
harhainen	neg	delusional
kysyntä	neg	demand
vaativa	neg	demanding
tylsistynyt	neg	demented
dementia	neg	dementia
kuolema	neg	demise
demokratia	pos	democracy
purkaa	neg	demolish
purkaminen	neg	demolition
demoni	neg	demon
demoninen	neg	demonic
todistettavissa	pos	demonstrable
demonstratiivinen	pos	demonstrative
moraali	neg	demoralized
kieltäminen	neg	denial
kiisti	neg	denied
tuomita	neg	denounce
tuomitseminen	neg	denunciation
kieltää	neg	deny
kieltää	neg	denying
lähti	neg	departed
lähtö	neg	departure
riippuvuus	neg	dependence
riippuvuus	neg	dependency
riippuvainen	pos	dependent
valitettava	neg	deplorable
valittaa	neg	deplore
karkottaa	neg	deport
karkotus	neg	deportation
turmeltunut	neg	depraved
turmelus	neg	depravity
laskea	neg	depreciate
poistot	neg	depreciated
arvonalennus	neg	depreciation
masentaa	neg	depress
masentunut	neg	depressed
masentava	neg	depressing
masennus	neg	depression
masentava	neg	depressive
riistäminen	neg	deprivation
syvyys	pos	depth
häiriintynyt	neg	deranged
ränsistynyt	neg	derelict
pilkka	neg	derision
Poikkeus	neg	derogation
halventava	neg	derogatory
kuvaileva	pos	descriptive
häpäiseminen	neg	desecration
autiomaa	neg	desert
autio	neg	deserted
hylkääminen	neg	desertion
ansaita	pos	deserve
ansaittu	pos	deserved
suunnittelija	pos	designer
toivottava	pos	desirable
haluten	pos	desiring
haluava	pos	desirous
pidättyä	neg	desist
hävitys	neg	desolation
epätoivo	neg	despair
epätoivoinen	neg	despairing
epätoivoinen	neg	desperate
halveksittava	neg	despicable
halveksia	neg	despise
itsevaltainen	neg	despotic
hirmuvalta	neg	despotism
määränpää	pos	destination
köyhä	neg	destitute
tuhonnut	neg	destroyed
hävittäjä	neg	destroyer
tuhoten	neg	destroying
tuho	neg	destruction
tuhoisa	neg	destructive
irrallisuus	neg	detachment
pidättää	neg	detain
poliittinen vanki	neg	detainee
havaita	pos	detect
havaitseminen	pos	detection
pidättäminen	neg	detention
heiketä	neg	deteriorate
huonontunut	neg	deteriorated
heikkeneminen	neg	deterioration
määritys	pos	determination
määräytyy	pos	determined
inhota	neg	detest
räjähtää	neg	detonate
vähennä	neg	detract
haitta	neg	detriment
haitallinen	neg	detrimental
sora	neg	detritus
tuhota	neg	devastate
tuhoisa	neg	devastating
tuho	neg	devastation
kehittää	pos	develop
paholainen	neg	devil
pirullinen	neg	devilish
mutkitteleva	neg	devious
hajautus	neg	devolution
harras	pos	devotional
niellä	neg	devour
hurskas	pos	devout
kätevyys	pos	dexterity
pirullinen	neg	diabolical
diagnoosi	neg	diagnosis
timantti	pos	diamond
päiväkirja	pos	diary
katkera arvostelu	neg	diatribe
diktaattori	neg	dictator
diktatorinen	neg	dictatorial
diktatuuri	neg	dictatorship
sanakirja	pos	dictionary
opettava	pos	didactic
kuolla	neg	die
ruokavalio-	pos	dietary
vaikeudet	neg	difficulties
vaikeus	neg	difficulty
arvokas	pos	dignified
arvokkuus	pos	dignity
eksyä	neg	digress
ränsistynyt	neg	dilapidated
ahkeruus	pos	diligence
laimentaa	neg	dilute
vähentää	neg	diminish
vähentynyt	neg	diminished
melu	neg	din
päivällinen	pos	dinner
diplomatia	pos	diplomacy
diplomaattinen	pos	diplomatic
hirveä	neg	dire
johtaja	pos	director
lika	neg	dirt
likainen	neg	dirty
vammaisuus	neg	disability
poista	neg	disable
vammaiset	neg	disabled
tyytymätön	neg	disaffected
olla eri mieltä	neg	disagree
erimielisyys	neg	disagreeing
erimielisyys	neg	disagreement
hylätyt	neg	disallowed
petä	neg	disappoint
pettynyt	neg	disappointed
ikävä	neg	disappointing
pettymys	neg	disappointment
paheksunta	neg	disapproval
hylkää	neg	disapprove
hylätty	neg	disapproved
tuomitseva	neg	disapproving
katastrofi	neg	disaster
tuhoisa	neg	disastrous
uskomatta	neg	disbelieve
poisheitetyt	neg	discards
päästö	neg	discharge
kuri	neg	discipline
kiistää	neg	disclaim
värjäytyminen	neg	discoloration
värjäytyneet	neg	discolored
epämukavuus	neg	discomfort
katkaista	neg	disconnect
irrotettu	neg	disconnected
katkaisu	neg	disconnection
tyytymättömyys	neg	discontent
lopettaa	neg	discontinue
katkonaisuus	neg	discontinuity
eripuraisuus	neg	discord
lannistaa	neg	discourage
lannistaa	neg	discouragement
löytö	pos	discovery
häpäistä	neg	discredit
hienovarainen	pos	discreet
harkintavalta	pos	discretion
harkinnanvarainen	pos	discretionary
syrjiä	neg	discriminate
arvostelukykyinen	neg	discriminating
syrjintä	neg	discrimination
keskustelu	pos	discussion
ylenkatse	neg	disdain
tauti	neg	disease
sairas	neg	diseased
aineeton	neg	disembodied
vetäytyminen	neg	disengagement
häirinneet	neg	disfigured
häpeä	neg	disgrace
häpäissyt	neg	disgraced
häpeällinen	neg	disgraceful
nyrpeä	neg	disgruntled
inho	neg	disgust
inhottava	neg	disgusting
lannistua	neg	disheartened
masentavaa	neg	disheartening
epärehellinen	neg	dishonest
epärehellisyys	neg	dishonesty
häpäistä	neg	dishonor
pettymys	neg	disillusionment
desinfiointi	pos	disinfection
harhaanjohtavat tiedot	neg	disinformation
vilpillinen	neg	disingenuous
hajota	neg	disintegrate
hajoaminen	neg	disintegration
välinpitämätön	neg	disinterested
vastenmielisyys	neg	dislike
inhosi	neg	disliked
sijoiltaan	neg	dislocated
synkkä	neg	dismal
kauhu	neg	dismay
silpominen	neg	dismemberment
irtisanominen	neg	dismissal
tottelemattomuus	neg	disobedience
tottelematon	neg	disobedient
olla tottelematta	neg	disobey
häiriö	neg	disorder
sekainen	neg	disorderly
sekava	neg	disorganized
väheksyä	neg	disparage
halveksiva	neg	disparaging
erilaisuus	neg	disparity
kiihkoton	neg	dispassionate
hälventää	neg	dispel
hajonta	neg	dispersion
syrjäyttää	neg	displace
ärsyyntynyt	neg	displeased
mielipaha	neg	displeasure
hävittäminen	neg	disposal
hävitettävä	pos	disposed
koditon	neg	dispossessed
riita	neg	dispute
esteellisyys	neg	disqualification
esteellinen	neg	disqualified
diskata	neg	disqualify
piittaamattomuus	neg	disregard
huomiotta	neg	disregarded
huonomaineinen	neg	disreputable
halveksinta	neg	disrespect
epäkunnioittava	neg	disrespectful
häiriö	neg	disruption
tyytymättömyys	neg	dissatisfaction
levittää	pos	disseminate
eripuraisuus	neg	dissension
eriävä	neg	dissenting
karhunpalvelus	neg	disservice
toisinajattelija	neg	dissident
liukeneminen	neg	dissolution
eripuraisuus	neg	dissonance
vastenmielisyys	neg	distaste
vastenmielinen	neg	distasteful
tislaus	pos	distillation
ero	pos	distinction
vääristynyt	neg	distorted
vääristymä	neg	distortion
häiritä	neg	distract
suunniltaan	neg	distracted
häiritsevää	neg	distracting
häiriötekijä	neg	distraction
suunniltaan	neg	distraught
hätä	neg	distress
levoton	neg	distressed
ahdistava	neg	distressing
epäluottamus	neg	distrust
häiriö	neg	disturbance
häiriintynyt	neg	disturbed
käyttömättömyys	neg	disuse
poistettujen	neg	disused
laulelma	pos	ditty
poikkeava	neg	divergent
monipuolinen	pos	diverse
monipuolinen	pos	diversified
harhautus	pos	diversion
myydyt	neg	divested
myynti	neg	divestment
jumaluus	pos	divinity
avioero	neg	divorce
huimaus	neg	dizziness
pyörryksissä	neg	dizzy
typistetty	neg	docked
lääkäri	pos	doctor
tekijä	pos	doer
sitkeä	pos	dogged
doit	neg	doit
lamakausi	neg	doldrums
työttömyyskorvaus	neg	dole
suru	neg	dolor
delfiini	pos	dolphin
hallitseva	neg	dominant
hallita	pos	dominate
ylivalta	neg	domination
don	pos	don
lahjoitus	pos	donation
aasi	neg	donkey
piirrellä	neg	doodle
tuomio	neg	doom
tuomittu	neg	doomed
tuomiopäivä	neg	doomsday
epäilys	neg	doubt
kyseenalainen	neg	doubtful
selviö	neg	doubting
epäilemättä	pos	doubtless
suihku	neg	douche
juro	neg	dour
kyyhky	pos	dove
kaatuminen	neg	downfall
untuvainen	pos	downy
ikävä	neg	drab
salaojitus	neg	drainage
haitta	neg	drawback
pelko	neg	dread
kauhea	neg	dreadful
kamalan	neg	dreadfully
kolkko	neg	dreary
juominen	neg	drinking
pöty	neg	drivel
surina	neg	drone
roikkuvat	neg	drooping
kuivuus	neg	drought
hukuttaa	neg	drown
uneliaisuus	neg	drowsiness
raadanta	neg	drudgery
humalainen	neg	drunken
juoppous	neg	drunkenness
kyseenalainen	neg	dubious
duetto	pos	duet
herttua	pos	duke
tylsä	neg	dull
tyhmä	neg	dumb
tutti	neg	dummy
kaatopaikkoja	neg	dumps
harmaanruskea	neg	dun
vankityrmä	neg	dungeon
huiputtaa	neg	dupe
kaksinaamaisuus	neg	duplicity
kestävyys	pos	durability
kestävä	pos	durable
pakko	neg	duress
pöly	neg	dust
velvollisuudentuntoinen	pos	dutiful
kääpiöityjen	neg	dwarfed
kuoleva	neg	dying
punatauti	neg	dysentery
innokas	pos	eager
innokkuus	pos	eagerness
jaarli	pos	earl
ansaita	pos	earn
innokas	pos	earnest
hartaasti	pos	earnestly
vakavuudella	pos	earnestness
maanjäristys	neg	earthquake
helppous	pos	ease
rasite	pos	easement
intohimoinen	pos	easygoing
syödä	pos	eat
salakuuntelu	neg	eavesdropping
ekstaasi	pos	ecstasy
hurmioitunut	pos	ecstatic
käskykirja	neg	edict
mielenylennys	pos	edification
kouluttaa	pos	educate
sivistynyt	pos	educated
koulutus-	pos	educational
tehokas	pos	effective
naismainen	neg	effeminate
tehokkuus	pos	efficacy
tehokkuus	pos	efficiency
tehokas	pos	efficient
ponnistus	pos	effort
itsekäs	neg	egotistical
törkeä	neg	egregious
siemensyöksy	pos	ejaculation
eject	neg	eject
häätö	neg	ejection
laatiminen	pos	elaboration
riemuissaan	pos	elated
vanhempi	pos	elder
vanhimmat	pos	elders
valitut	pos	elect
sähköinen	pos	electric
sähkö	pos	electricity
tyylikkyys	pos	elegance
tyylikäs	pos	elegant
korkeus	pos	elevation
oikeutettu	pos	eligible
eliminointi	neg	elimination
eliitti	pos	elite
puhetaito	pos	eloquence
kaunopuheinen	pos	eloquent
valaista	pos	elucidate
saavuttamaton	neg	elusive
laihtunut	neg	emaciated
emansipaatio	pos	emancipation
kauppasaarto	neg	embargo
nolata	neg	embarrass
kiusallinen	neg	embarrassing
hämmennys	neg	embarrassment
kavallus	neg	embezzlement
veritulppa	neg	embolism
syleillä	pos	embrace
sotkeutunut	neg	embroiled
hätä-	neg	emergency
emeritus	pos	emeritus
kohouma	pos	eminence
etevä	pos	eminent
ilmeisen	pos	eminently
emiiri	pos	emir
empatia	pos	empathy
valtuuttaa	pos	empower
jäljitellä	pos	emulate
mahdollistaa	pos	enable
Enablement	pos	enablement
hurmata	pos	enchant
lumottu	pos	enchanted
lumoava	pos	enchanting
erillisalue	neg	enclave
encore	pos	encore
rohkaista	pos	encourage
rohkaisu	pos	encouragement
loukkaus	neg	encroachment
rasitteena	neg	encumbrance
tietosanakirja	pos	encyclopedia
vaarantaa	neg	endanger
uhanalainen	neg	endangered
yrittää	pos	endeavor
endeeminen	neg	endemic
loputon	pos	endless
antaa	pos	endow
suotu	pos	endowed
lahjoitusvarat	pos	endowment
kestävyys	pos	endurance
kestää	pos	endure
vihollinen	neg	enemy
energinen	pos	energetic
valvoa	pos	enforce
täytäntöönpano	neg	enforcement
kihloissa	pos	engaged
harjoittaa	pos	engaging
parantaa	pos	enhance
arvoituksellinen	neg	enigmatic
nauttia	pos	enjoy
nauttia	pos	enjoying
valaista	pos	enlighten
valistus	pos	enlightenment
elävöittää	pos	enliven
vihamielisyys	neg	enmity
rikastuttaa	pos	enrich
yhtye	pos	ensemble
lippu	pos	ensign
orjuuttaa	neg	enslave
orjuutettu	neg	enslaved
orjuuttaminen	neg	enslavement
kietoutunut	neg	entangled
kietoutuminen	neg	entanglement
yritteliäs	pos	enterprising
viihdyttää	pos	entertain
viihdyttivät	pos	entertained
huvittava	pos	entertaining
viihde	pos	entertainment
innostus	pos	enthusiasm
intoilija	pos	enthusiast
sisälmykset	neg	entrails
kateellinen	neg	envious
environ	pos	environ
ephemeris	pos	ephemeris
eeppinen	pos	epic
epidemia	neg	epidemic
epilepsia	neg	epilepsy
ruumiillistuma	pos	epitome
tasa-arvo	pos	equality
yhtäläisesti	pos	equally
tasapaino	pos	equilibrium
oma pääoma	pos	equity
hävittää	neg	eradicate
hävittämistä	neg	eradication
pyyhkiä	neg	erase
eroosio	neg	erosion
eroottinen	pos	erotic
erehtyä	neg	err
asialla	pos	errand
hairahtunut	neg	errant
arvaamaton	neg	erratic
painovirhe	neg	erratum
virheellinen	neg	erroneous
virhe	neg	error
oppinut	pos	erudite
puhjeta	neg	erupt
purkaus	neg	eruption
laajeta	neg	escalate
paeta	pos	escape
karttaa	neg	eschew
vakoilu	neg	espionage
esprit	pos	esprit
olennainen	pos	essential
vakiintunut	pos	established
kunnioitus	pos	esteem
esteettinen	pos	esthetic
vieraantunut	neg	estranged
eettinen	pos	ethical
etiikka	pos	ethics
eutanasia	neg	euthanasia
evakuoida	neg	evacuate
evakuointi	neg	evacuation
väistää	neg	evade
välttely	neg	evasion
ikivihreä	pos	evergreen
ikuinen	pos	everlasting
häätää	neg	evict
häätö	neg	eviction
ilmeinen	pos	evident
paha	neg	evil
evoluutio	pos	evolution
ylentää	pos	exalt
ylevä	pos	exalted
erinomainen	pos	excellent
kiihottaa	pos	excite
jännittävä	pos	exciting
uupunut	neg	exhausted
eksoottinen	pos	exotic
selittää	pos	explain
räjähtää	neg	explode
räjähdys	neg	explosion
erinomainen	pos	exquisite
ylimääräinen	pos	extra
usko	pos	faith
laskussa	neg	falling
Kuuluisa	pos	famous
lumoava	pos	fascinating
viallinen	neg	faulty
suosikki	pos	favorite
pelko	neg	fear
peloton	pos	fearless
saavutus	pos	feat
ominaisuus	pos	feature
maksu	neg	fee
taistella	neg	fight
hiutale	neg	flake
laivasto	pos	fleet
joustavuus	pos	flexibility
virtaus	pos	flow
flunssa	neg	flu
väri	pos	flush
lentävä	pos	flying
fokus	pos	focus
ruoka	pos	food
voima	neg	force
työnjohtaja	pos	foreman
takoa	pos	forge
unohtaa	neg	forget
kaava	pos	formula
linnoitus	pos	fortress
kireä	neg	fraught
vimma	neg	frenzy
ystävä	pos	friend
ystävällinen	pos	friendly
ystävyys	pos	friendship
täyttymys	pos	fulfillment
täysi	pos	full
savuta	neg	fume
hauska	pos	fun
fuusio	pos	fusion
hyöty	pos	gain
uhkapeli	neg	gamble
jengi	neg	gang
roskat	neg	garbage
puutarha	pos	garden
vaihde	pos	gear
helmi	pos	gem
yleinen	pos	general
lahja	pos	gift
antaminen	pos	giving
pilkahdus	pos	glimmer
kunnia	pos	glory
hehku	pos	glow
jumala	pos	god
kulta	pos	gold
liisteri	neg	goo
hyvä	pos	good
huijata	neg	gouge
napata	neg	grab
armo	pos	grace
sorja	pos	graceful
isoäiti	pos	grandmother
suuruus	pos	greatness
ahne	neg	greedy
vihreä	pos	green
tervehdys	pos	greeting
virne	pos	grin
kasvaa	pos	grow
marmattaa	neg	grumble
vartija	pos	guard
opastus	pos	guidance
opas	pos	guide
syyllisyys	neg	guilt
syyllinen	neg	guilty
onnellisuus	pos	happiness
onnellinen	pos	happy
harmonia	pos	harmony
sato	pos	harvest
kaaos	neg	havoc
taivaat	pos	heavens
helvetti	neg	hell
auttaja	pos	helper
hilpeä	pos	hilarious
vuokraus	pos	hire
osuma	neg	hit
pesää	neg	hive
harraste	pos	hobby
loma	pos	holiday
pyhä	pos	holy
rehellinen	pos	honest
häämatka	pos	honeymoon
toivo	pos	hope
toiveikas	pos	hopeful
kauhu	neg	horror
talous	pos	household
halata	pos	hug
inhimillinen	pos	humane
metsästäjä	neg	hunter
metsästys	neg	hunting
satuttaa	neg	hurt
kota	pos	hut
tietämättömyys	neg	ignorance
illuusio	neg	illusion
heti	pos	immediately
tärkeys	pos	importance
tärkeä	pos	important
tähdentää	pos	impress
parantunut	pos	improved
Sisältää	pos	included
mukaan lukien	pos	including
tulo	pos	income
epäpätevä	neg	incompetent
lisätä	pos	increase
itsenäisyys	pos	independence
ääretön	pos	infinite
perintö	pos	inheritance
viattomuus	pos	innocence
innovaatio	pos	innovation
tiedustelu	pos	inquiry
opetus	pos	instruction
rehellisyys	pos	integrity
älykäs	pos	intelligent
kanssakäyminen	pos	intercourse
mielenkiintoinen	pos	interesting
invaasio	neg	invasion
kutsu	pos	invite
viha	neg	ire
rauta	pos	iron
jättipotti	pos	jackpot
hillo	pos	jam
mustasukkainen	neg	jealous
Johannes	neg	john
liittää	pos	join
vitsi	neg	joke
journalisti	pos	journalist
matka	pos	journey
ilo	pos	joy
hypätä	pos	jump
romu	neg	junk
oikeudenmukaisuus	pos	justice
potkia	neg	kick
ystävällinen	pos	kind
kuningas	pos	king
suudelma	pos	kiss
kissanpentu	pos	kitten
ritari	pos	knight
tieto	pos	knowledge
maa	pos	land
varkaus	neg	larceny
laser	pos	laser
luimia	neg	lash
myöhäinen	neg	late
nauraa	pos	laugh
laava	neg	lava
löyhä	neg	lax
laiska	neg	lazy
johtaja	pos	leader
oppia	pos	learn
oppiminen	pos	learning
jättää	neg	leave
oikeudellinen	pos	legal
vapaa-aika	pos	leisure
sitruuna	neg	lemon
lievä	pos	lenient
vero	neg	levy
valehtelija	neg	liar
vapaus	pos	liberty
nuolla	neg	lick
leijona	pos	lion
leipä	neg	loaf
yksinäinen	neg	lonely
yksinäinen	neg	lonesome
vessa	neg	loo
kangaspuut	neg	loom
ryöstää	neg	loot
herra	pos	lord
menettää	neg	lose
menetetty	neg	lost
rakkaus	pos	love
ihana	pos	lovely
rakastaja	pos	lover
uskollinen	pos	loyal
uskollisuus	pos	loyalty
onni	pos	luck
onnekas	pos	lucky
möykky	neg	lump
hullu	neg	mad
hulluus	neg	madness
upea	pos	magnificent
neito	pos	maiden
ilkeys	neg	malice
mania	neg	mania
maaliskuu	neg	mar
markiisi	pos	marquis
ihmeellinen	pos	marvelous
mestari	pos	master
lääketieteellinen	pos	medical
iloinen	pos	merry
sotku	neg	mess
puuttuva	neg	missing
malli	pos	model
raha	pos	money
munkki	pos	monk
yksivärinen	neg	monochrome
hirviö	neg	monster
muistomerkki	pos	monument
moraalinen	pos	moral
musiikki	pos	music
torkut	pos	nap
laiminlyöty	neg	neglected
naapuri	pos	neighbor
nepotismi	neg	nepotism
nekru	neg	nigger
ravinto	pos	nourishment
tunnoton	neg	numb
numerot	pos	numbers
sairaanhoitaja	pos	nurse
hoivata	pos	nurture
liikalihavuus	neg	obesity
loukata	neg	offend
hyökkäys	neg	offensive
tarjous	pos	offer
hirviö	neg	ogre
vaihtoehto	pos	option
valinnainen	pos	optional
orc	neg	orc
organisaatio	pos	organization
järjestää	pos	organize
täyte	pos	padding
paraati	pos	parade
kumppani	pos	partner
intohimoinen	pos	passionate
läikkä	neg	patch
kärsivällisyys	pos	patience
kärsivällinen	pos	patient
maksu	neg	payment
rauha	pos	peace
täydellinen	pos	perfect
peril	neg	peril
lisäansiot	pos	perk
lupa	pos	permission
sitkeys	pos	persistence
tuhoeläin	neg	pest
lemmikki	neg	pet
fysiikka	pos	physics
piknikki	pos	picnic
sika	neg	pig
tyyny	pos	pillow
lentäjä	pos	pilot
merirosvo	neg	pirate
suunnittelu	pos	planning
pelaaja	neg	player
leikkipuisto	pos	playground
valitusperuste	neg	plea
miellyttävä	pos	pleasant
iloinen	pos	pleased
ryöstää	neg	plunder
poliisi	pos	police
pop	neg	pop
piikkisika	neg	porcupine
porno	neg	porn
omistaa	pos	possess
riivattu	neg	possessed
punta	neg	pound
voimakas	pos	powerful
ylistys	pos	praise
kepponen	neg	prank
kallisarvoinen	pos	precious
tarkka	pos	precise
pääministeri	pos	premier
valmistettu	pos	prepared
teeskennellä	neg	pretend
prinsessa	pos	princess
edistyminen	pos	progress
progressiivinen	pos	progressive
kielto	neg	prohibition
oikea	pos	proper
suojelija	pos	protector
pöhöttynyt	neg	puffy
booli	neg	punch
pentu	pos	puppy
mätä	neg	pus
etsintä	pos	quest
kysymys	pos	question
hiljainen	pos	quiet
tietokilpailu	neg	quiz
lainaus	pos	quote
säteilevä	pos	radiant
luokitus	neg	rating
raivoava	neg	raving
real	pos	real
sai	pos	received
elpyminen	pos	recovery
kieltäytyi	neg	refused
pahoitella	neg	regret
korvaus	pos	reimbursement
hillitä	neg	rein
vahvistaminen	pos	reinforcement
nuorentaa	pos	rejuvenate
rentoutuminen	pos	relaxation
luotettava	pos	reliable
huomattava	pos	remarkable
poistaa	neg	remove
toimittaja	pos	reporter
tasavalta	neg	republic
varanto	pos	reserve
resurssit	pos	resources
herkkä	pos	responsive
palauttaminen	pos	restoring
rajoittaa	neg	restrict
tarkistaa	pos	revise
vallankumous	pos	revolution
palkinto	pos	reward
ratsastaja	pos	rider
riski	neg	risk
rock	pos	rock
rivi	neg	row
ruoste	neg	rust
painua	neg	sag
salvia	pos	sage
raakuus	neg	savagery
säästää	pos	save
syntipukki	neg	scapegoat
pelästyttää	neg	scare
pisteet	pos	score
hangata	neg	scrub
meri	pos	sea
tiiviste	pos	seal
ruskistaa	neg	sear
lause	neg	sentence
vahti	pos	sentinel
palvelija	neg	servant
sukupuoli	pos	sex
muoto	pos	shape
osake	pos	share
hai	neg	shark
suoja	pos	shelter
paimen	pos	shepherd
loistaa	pos	shine
paska	neg	shit
ampua	neg	shoot
ostokset	pos	shopping
sairas	neg	sick
synti	neg	sin
taivas	pos	sky
surmata	neg	slay
räntä	neg	sleet
pieni	neg	small
tukahduttaa	neg	smother
käärme	neg	snake
maaperä	neg	soil
ratkaisu	pos	solution
soulmate	neg	soulmate
keitto	pos	soup
pikkutarkka	neg	squeamish
litinä	neg	squelch
pysähdyksissä	neg	standstill
tähti	pos	star
tila	pos	status
osakkeet	neg	stocks
kivi	neg	stone
työnseisaus	neg	stoppage
myymälä	pos	store
myrsky	neg	storm
vahvuus	pos	strength
tutkimus	pos	study
tyhmä	neg	stupid
sokeri	pos	sugar
aurinko	pos	sun
aurinkoinen	pos	sunny
erinomainen	pos	superior
tarvikkeet	pos	supplies
tuettu	pos	supported
soinen	neg	swampy
makea	pos	sweet
myötätunto	pos	sympathy
tarina	pos	tale
talismaani	pos	talisman
puhua	pos	talk
tehtävä	pos	task
opettaja	pos	teacher
teknologia	pos	technology
houkutus	neg	temptation
vuokralainen	pos	tenant
tarjous	pos	tender
irtisanominen	neg	termination
kiittäminen	pos	thanksgiving
huomaavainen	pos	thoughtful
uhkaus	neg	threat
otsikko	pos	title
paahtoleipä	pos	toast
WC	neg	toilet
toppi	pos	top
torni	pos	tower
myrkyllinen	neg	toxic
perinteinen	pos	traditional
kulkuri	neg	tramp
roska	neg	trash
aarre	pos	treasure
kohdella	pos	treat
puu	pos	tree
peikko	neg	troll
totta	pos	1
rojahtaa	neg	tumble
turbulenssi	neg	turbulence
twin	pos	twin
taifuuni	neg	typhoon
ruma	neg	ugly
haavauma	neg	ulcer
alleviivata	pos	underline
ainutlaatuinen	pos	unique
yliopisto	pos	university
epävirallinen	neg	unofficial
loma	pos	vacation
vampyyri	neg	vampire
elinvoima	pos	vigor
virus	neg	virus
visio	pos	vision
vierailu	pos	visit
elävä	pos	vivid
taata jk	pos	vouch
alttius	neg	vulnerability
odota	neg	wait
sota	neg	war
loimi	neg	warp
paino	pos	weight
outo	neg	weird
tyytyväinen	pos	welcomed
valkoinen	pos	white
huora	neg	whore
villi	neg	wild
voittoisa	pos	winning
viisaus	pos	wisdom
peruuttaa	neg	withdraw
velho	pos	wizard
ihana	pos	wonderful
sanoja	neg	words
työskentely	pos	working
palvonta	pos	worship
nuori	pos	young
vetoketju	neg	zip
